1 1 1 1 1 1 1 1 1 1 1 1 1 1 1 1 1 1 1 1
1 0 0 0 0 0 0 0 0 0 0 0 0 0 0 0 0 0 0 1
1 0 0 0 0 0 0 0 0 0 0 0 0 0 0 0 0 0 0 1
1 0 0 2 0 0 0 0 0 0 0 0 0 0 0 0 0 0 0 1
1 0 0 2 0 0 0 0 0 0 0 0 0 0 0 0 0 0 0 1
1 0 0 2 0 0 0 0 0 0 0 0 0 0 0 0 0 0 0 1
1 0 0 2 0 0 0 0 0 0 0 0 0 0 0 0 0 0 0 1
1 0 0 2 0 0 0 0 0 0 0 0 0 0 0 0 0 0 0 1
1 0 0 2 2 2 2 2 2 0 0 3 3 3 8 3 3 0 0 1
1 0 0 0 0 0 0 0 0 0 0 3 0 0 0 0 3 0 0 1
1 0 0 3 3 3 3 3 3 0 0 3 0 0 0 0 3 0 0 1
1 0 0 0 0 0 0 0 3 0 0 3 0 0 0 0 3 0 0 1
1 0 0 0 0 0 0 0 3 3 3 3 0 0 3 3 3 0 0 1
1 0 0 3 3 3 3 3 3 0 0 0 0 0 2 0 0 0 0 1
1 0 0 0 0 0 0 0 3 3 3 2 0 0 2 0 0 0 0 1
1 0 0 0 0 0 0 0 0 0 0 2 8 2 2 0 0 0 0 1
1 0 0 3 3 3 3 3 3 0 0 0 0 0 0 0 0 0 0 1
1 0 0 0 0 0 0 0 0 0 0 0 0 0 0 0 0 0 0 1
1 0 0 0 0 0 0 0 0 0 0 0 0 0 0 0 0 0 0 1
1 1 1 1 1 1 1 1 1 1 1 1 1 1 1 1 1 1 1 1
